111111111111111111111111111RRR111111111111111111111111
100A00000000001ZZZZZZZZ1000RYR001ZZZZZZZZ1000001ZZZZZ1
100S00000000001ZZZZZZZZ1000RYR001ZZZZZZZZ1000001ZZBZZ1
100S00000000001000000001000RYR00100000000100000110S001
100S00000000000000000000000RRR00000000000000000000S001
100S00000000001111XX1111000RRR001111XX111100000000S001
100SSSSSSSSSSSSSSSSSSSSSSSSLLLSSSSSSSSSSSSSSSSSSSSS001
100S00000000000000000000000RYR000000000000000000000001
111X11111111111111111U11111RYR111X111111111111111X1111
RRRXRRRRRRRRRRRRRRRRRURRRRRRRRRRRXRRRRRRRRRRRRRRRXRRRR
RRYXYRRRYYYRRRYYYRRRYUYRRRYYYRRRYXYRRRYYYRRRYYYRRXYYYR
RRRXRRRRRRRRRRRRRRRRRURRRRRRRRRRRXRRRRRRRRRRRRRRRXRRRR
111X11111111111111111U11111RRR111X111111111111111X1111
100S00000000000000000000000RYR0000000000000000000S0001
100SSSSSSSSSSSSSSSSSSSSSSSSLLLSSSSSSSSSSSSSSSSSSSSS001
111111111111101111111111110RYR00000000000000000000S001
10000000000000SSSSSSSSSSS10RRR1111ZZZZZZZZZZ111100S001
101111111111111111111111S10RRR1ZZZZZZZZZZZZZZZZ100S001
101000000000000000000001S10RRR1ZZZZZZZZZZZZZZZZ100S001
101011111111111111111101S10RYR11111111111111111100E001
101010000000000000000101S10RYR000000000000000000000001
101010111111111111110101S00RYR000000000000000000000001
1010101000000SSSSSS10101S10RRR000000000000000000000001
101010101111011111S10101S10RRR1111ZZZZDZZZZZ1111000001
101000101000000001S10001S10RRR1ZZZZZZZZZZZZZZZZ1000001
101111101010C01001S11111S10RYR1ZZZZZZZZZZZZZZZZ1000001
100000001011101101SSSSSSS10RYR111111111111111111000001
111111111111101111111111110RYR000000000000000000000001
100000000000000000000000000RRR000000000000000000000001
111111111111111111111111111RRR111111111111111111111111