00000000000000000000000000000000001000000000000000000
00000000000000000000000000000000001000000000000000000
0A00000000000000000000000000000000100ZZ000ZZ000ZZE000
0000000000000000000000000000000000100ZZ000ZZ000ZZ0000
000S000000000000000000000000000000100000000000000S000
000S000000011110000000000000000000100ZZ000ZZ000ZZS000
000S000000000000000000000000000000100ZZ000ZZ000ZZS000
000S0000000000000000000000000000001000000SSSSSSSSS000
000S000000000000000000000000000000100ZZ00SZZ000ZZ0000
000S000000000000000000000011100000100ZZ00SZZ000ZZ0000
00BS000000000000000000D000100000000SSSSSSS00000000000
00000000000000000000000000100000000100000000000000000
00000000000C00000000000000100000001111111111111111111
00000000000000000000000000000000000000000000000000000
00000000000000000000000000000000000000000000000000000
00000000000000000000000000000000000000000000000000000
0000000000000000000000000000000000ZZ00000000000000000
00000000000000000000000000000000000000000000000000000
0000000000000000000000000000000000ZZ00000000000000000
00000000000000000000000000000000000000000000000000000
00000000000000000000000000000000000000000000000000000
00000000000000000000000000000000000000000000000000000
00000000000000000000000000000000000000000000000000000
00000000000000000000000000000000000000000000000000000
00000000000000000000000000000000000000000000000000000
00000000000000000000000000000000000000000000000000000
00000000000000000000000000000000000000000000000000000
00000000000000000000000000000000000000000000000000000
00000000000000000000000000000000000000000000000000000
